10

02 02 02 02 02 02 02 02 02 02
02 10 10 10 10 10 10 10 10 02
02 10 10 10 10 10 10 10 10 02
02 10 10 10 10 10 10 10 10 02
02 10 10 10 10 10 10 10 10 02
02 10 10 10 10 10 10 10 10 02
02 10 10 10 10 10 10 10 10 02
02 10 10 10 10 10 10 10 10 02
02 02 02 02 02 02 02 02 02 02