24

02 02 02 02 02 02 02 02 02 02
02 10 13 10 10 10 10 10 10 02
02 10 10 10 10 10 10 10 10 02
02 10 10 04 10 10 10 10 10 02
02 13 10 10 10 10 02 13 10 02
02 10 10 10 10 10 02 10 10 02
02 10 13 02 02 02 11 10 10 02
02 10 10 02 10 10 10 13 10 02
02 02 02 02 02 02 02 02 02 02
