17

02 02 02 02 02 02 02 02 02 02
02 10 10 10 10 02 10 10 10 02
02 10 11 10 10 16 13 10 10 02
02 10 10 10 10 10 02 02 10 02
02 10 10 10 10 10 10 10 10 02
02 10 13 10 15 10 10 10 10 02
02 10 10 02 13 10 10 04 10 02
02 10 10 10 02 10 10 10 10 02
02 02 02 02 02 02 02 02 02 02
