22

02 02 02 02 02 02 02 02 02 02
02 10 02 10 10 10 02 10 11 02
02 10 10 13 10 10 10 10 10 02
02 10 10 10 10 10 16 14 10 02
02 10 10 10 10 10 10 10 10 02
02 10 10 02 10 10 10 10 10 02
02 10 02 10 10 10 10 15 10 02
02 10 02 13 02 10 10 13 10 02
02 02 02 02 02 02 02 02 02 02