12

02 02 02 02 02 02 02 02 02 02
02 10 10 10 10 10 10 10 10 02
02 10 10 10 02 10 13 10 10 02
02 02 10 10 10 10 10 10 10 02
02 10 13 15 10 10 10 10 02 02
02 10 11 10 10 10 13 02 10 02
02 10 10 10 10 10 16 04 10 02
02 10 10 10 10 02 10 10 10 02
02 02 02 02 02 02 02 02 02 02