25

02 02 02 02 02 02 02 02 02 02
02 04 10 10 10 10 10 10 13 02
02 15 10 10 10 10 10 10 16 02
02 10 10 13 10 10 10 02 10 02
02 02 02 10 10 10 10 10 10 02
02 13 10 10 10 10 10 10 10 02
02 10 10 10 10 10 16 10 10 02
02 10 02 10 10 10 11 10 10 02
02 02 02 02 02 02 02 02 02 02